,age,ast,blk,drb,fg,fg_2,fg_2_a,fg_3,fg_3_a,fga,ft,fta,gp,gs,mp,orb,pf,player,pos,pts,stl,tov,trb
0,23,40,8,68,134,40,94,94,247,341,44,49,68,6,1055,18,114,Alex Abrines,SG,406,37,33,86
1,26,18,15,95,70,33,80,37,90,170,45,60,38,1,558,20,67,Quincy Acy,PF,222,14,21,115
2,23,86,78,333,374,374,654,0,1,655,157,257,80,80,2389,282,195,Steven Adams,C,905,88,146,615
3,31,78,7,116,185,123,269,62,151,420,83,93,61,45,1580,9,104,Arron Afflalo,SG,515,21,42,125
4,28,12,22,131,89,89,174,0,4,178,29,40,39,15,584,46,77,Alexis Ajinca,C,207,20,31,177
5,28,25,23,107,45,45,86,0,0,86,15,22,62,0,531,51,85,Cole Aldrich,C,105,25,17,158
6,31,139,89,350,500,477,993,23,56,1049,220,271,72,72,2335,174,158,LaMarcus Aldridge,PF,1243,46,98,524
7,27,57,24,115,77,77,167,0,1,168,23,33,61,5,871,105,78,Lavoy Allen,PF,177,18,29,220
8,35,98,29,225,274,259,541,15,54,595,80,130,71,66,1914,166,178,Tony Allen,SG,643,115,100,391
9,26,99,44,374,183,113,254,70,212,466,96,136,61,25,1773,77,102,Al-Farouq Aminu,SF,532,60,94,451
10,38,5,7,22,9,9,19,0,3,22,10,14,12,0,114,9,20,Chris Andersen,C,28,5,5,31
11,34,11,0,21,30,16,36,14,44,80,12,16,30,0,308,3,35,Alan Anderson,SF,86,3,7,24
12,23,66,23,176,186,128,245,58,194,439,102,129,75,10,1228,69,109,Justin Anderson,SF,532,41,66,245
13,23,91,26,175,93,78,169,15,40,209,45,57,72,14,1020,33,63,Kyle Anderson,SG,246,51,39,208
14,28,68,14,218,323,119,267,204,506,773,129,150,72,72,2116,112,142,Ryan Anderson,PF,979,32,55,330
15,22,434,151,558,656,607,1079,49,180,1259,471,612,80,80,2845,142,246,Giannis Antetokounmpo,SF,1832,131,234,700
16,32,213,34,374,602,451,968,151,421,1389,304,365,74,74,2538,62,198,Carmelo Anthony,SF,1659,60,153,436
17,34,3,6,23,10,10,16,0,0,16,5,8,19,0,122,8,11,Joel Anthony,C,25,2,4,31
18,31,175,20,405,326,135,243,191,555,798,93,126,80,80,2773,54,133,Trevor Ariza,SF,936,147,74,459
19,28,42,21,87,95,42,98,53,117,215,19,22,41,7,639,25,76,Darrell Arthur,PF,262,19,36,112
20,30,15,10,115,31,31,65,0,0,65,23,39,31,19,482,48,51,Omer Asik,C,85,5,14,163
21,29,209,1,102,195,100,243,95,274,517,131,161,78,20,1538,15,101,D.J. Augustin,PG,616,31,90,117
22,27,36,11,129,113,26,71,87,210,281,11,15,68,55,1065,13,118,Luke Babbitt,SF,324,21,25,142
23,23,107,8,86,82,59,131,23,86,217,28,43,52,13,857,12,74,Ron Baker,SG,215,34,56,98
24,20,61,7,35,36,33,93,3,22,115,31,37,33,1,405,11,40,Wade Baldwin,PG,106,18,40,46
25,34,81,8,89,172,137,294,35,98,392,40,45,67,0,963,15,82,Leandro Barbosa,SG,419,31,48,104
26,32,193,1,75,142,89,195,53,148,343,44,51,35,6,771,9,30,J.J. Barea,PG,381,14,63,84
27,24,117,15,303,599,521,1058,78,222,1280,242,281,79,79,2803,94,128,Harrison Barnes,PF,1518,66,102,397
28,36,194,26,317,185,98,210,87,263,473,70,89,74,18,1777,70,185,Matt Barnes,SF,527,48,107,387
29,26,206,28,200,295,208,431,87,235,666,143,190,60,19,1705,58,110,Will Barton,SG,820,48,97,258
30,31,21,11,86,107,106,183,1,3,186,77,88,52,0,577,43,45,Brandon Bass,PF,292,14,29,129
31,28,455,29,435,393,258,570,135,405,975,243,284,77,77,2617,46,109,Nicolas Batum,SG,1164,86,194,481
32,28,13,0,9,11,9,27,2,5,32,9,10,3,1,71,3,4,Jerryd Bayless,PG,33,0,9,12
33,30,32,39,222,143,143,279,0,0,279,79,94,75,2,1163,111,166,Aron Baynes,C,365,17,50,333
34,27,177,52,186,295,203,455,92,266,721,119,168,73,64,1963,45,165,Kent Bazemore,SF,801,91,125,231
35,23,267,21,186,637,414,770,223,552,1322,282,342,77,77,2684,53,169,Bradley Beal,SG,1779,83,157,239
36,20,11,0,12,33,24,45,9,28,73,8,10,22,1,165,5,10,Malik Beasley,SG,83,7,8,17
37,28,53,27,153,216,198,363,18,43,406,78,105,56,6,935,40,92,Michael Beasley,PF,528,28,66,193
38,30,147,9,164,264,162,332,102,283,615,150,168,74,0,1778,14,90,Marco Belinelli,SG,780,44,70,178
39,22,28,5,45,47,46,80,1,18,98,6,16,38,1,371,14,21,DeAndre' Bembry,SF,101,8,16,59
40,19,23,22,80,57,29,60,28,101,161,4,11,43,0,574,23,74,Dragan Bender,PF,146,10,32,103
41,23,12,3,53,38,25,44,13,48,92,26,36,23,1,264,25,18,Anthony Bennett,PF,115,5,12,78
42,21,0,0,2,0,0,2,0,1,3,0,0,3,0,10,0,1,Ben Bentil,PF,0,0,1,2
43,24,46,28,77,103,34,61,69,173,234,28,34,67,6,808,22,75,Davis Bertans,PF,303,20,32,99
44,28,281,25,299,228,118,255,110,288,543,73,95,67,67,2058,95,222,Patrick Beverley,SG,639,99,100,394
45,24,74,91,410,179,179,339,0,0,339,125,234,81,27,1793,157,202,Bismack Biyombo,C,483,25,95,567
46,28,79,20,187,151,95,179,56,177,356,45,61,65,1,1190,57,154,Nemanja Bjelica,PF,403,40,59,244
47,25,39,44,199,150,149,292,1,2,294,82,109,67,16,1091,143,173,Tarik Black,C,383,30,58,342
48,27,418,31,268,449,345,724,104,310,1034,388,458,66,66,2176,52,164,Eric Bledsoe,PG,1390,92,223,320
49,27,111,7,240,376,232,453,144,392,845,217,243,81,54,2083,37,146,Bojan Bogdanovic,SF,1113,34,130,277
50,32,49,25,162,38,38,80,0,1,81,3,11,27,21,583,56,86,Andrew Bogut,C,79,13,43,218
51,23,2,2,13,9,8,12,1,4,16,3,6,12,0,53,4,1,Joel Bolomboy,PF,22,1,2,17
52,20,268,21,203,606,459,1026,147,405,1431,367,441,78,78,2730,46,242,Devin Booker,SG,1726,72,241,249
53,29,138,28,428,305,280,513,25,78,591,74,110,71,43,1754,142,152,Trevor Booker,PF,709,76,127,570
54,26,121,11,269,359,251,498,108,277,775,68,93,55,55,1835,65,141,Avery Bradley,SG,894,68,88,334
55,30,97,19,134,147,120,230,27,118,348,50,68,82,11,1281,32,133,Corey Brewer,SF,371,61,55,166
56,24,317,12,166,290,212,442,78,193,635,109,126,75,28,1982,47,140,Malcolm Brogdon,SG,767,84,113,213
57,32,125,9,51,121,73,172,48,128,300,32,40,65,0,894,18,93,Aaron Brooks,PG,322,25,66,69
58,24,8,1,25,18,11,23,7,27,50,0,0,11,0,159,8,15,Anthony Brown,SF,43,5,6,33
59,32,14,0,6,23,9,25,14,35,60,2,2,25,0,123,0,5,Bobby Brown,PG,62,1,5,6
60,20,64,18,175,192,146,288,46,135,423,85,124,78,20,1341,45,142,Jaylen Brown,SF,515,35,68,220
61,23,47,8,69,52,23,46,29,95,141,17,22,54,2,521,26,43,Nicolas Brussino,SF,150,17,26,95
62,25,29,3,51,54,26,55,28,73,128,5,7,31,5,467,13,22,Reggie Bullock,SF,141,18,10,64
63,24,100,5,40,116,85,185,31,70,255,22,29,57,0,703,7,54,Trey Burke,PG,285,11,48,47
64,25,30,5,103,99,74,172,25,76,248,60,78,42,0,653,17,50,Alec Burks,SG,283,18,35,120
65,27,417,32,341,570,479,1004,91,248,1252,585,676,76,75,2809,129,112,Jimmy Butler,SF,1816,143,159,470
66,21,4,1,5,6,4,10,2,6,16,0,0,9,0,40,5,4,Bruno Caboclo,SF,14,2,2,10
67,35,88,1,59,55,35,70,20,64,134,11,12,41,13,539,15,36,Jose Calderon,PG,141,11,41,74
68,23,193,12,193,370,217,491,153,437,928,154,185,76,75,2529,55,118,Kentavious Caldwell-Pope,SG,1047,89,86,248
69,25,37,1,43,63,38,79,25,94,173,30,33,39,0,592,6,35,Isaiah Canaan,SG,181,22,20,49
70,22,64,80,348,362,362,563,0,0,563,94,177,65,59,1551,178,179,Clint Capela,C,818,34,87,526
71,30,74,27,212,220,111,229,109,320,549,89,117,72,72,1882,63,143,DeMarre Carroll,SF,638,81,54,275
72,40,133,36,191,193,81,194,112,296,490,88,115,73,15,1799,36,163,Vince Carter,SF,586,60,50,227
73,25,113,23,128,112,97,242,15,64,306,58,77,45,19,846,24,102,Michael Carter-Williams,PG,297,38,66,152
74,28,37,3,85,77,62,122,15,43,165,17,29,36,2,643,27,50,Omri Casspi,SF,186,23,29,112
75,23,80,45,255,255,255,479,0,2,481,101,151,75,21,1421,85,147,Willie Cauley-Stein,C,611,53,69,340
76,34,30,24,385,153,153,228,0,0,228,91,124,47,46,1298,154,126,Tyson Chandler,C,397,33,67,539
77,29,141,30,356,433,323,613,110,326,939,141,194,71,33,2197,103,172,Wilson Chandler,SF,1117,52,114,459
78,19,60,70,252,284,212,408,72,224,632,113,181,82,75,1743,96,263,Marquese Chriss,PF,753,67,108,348
79,25,4,6,30,19,19,43,0,0,43,21,29,29,0,219,26,37,Rakeem Christmas,PF,59,3,8,56
80,24,130,6,69,77,65,160,12,63,223,17,31,64,1,973,19,79,Semaj Christon,PG,183,28,43,88
81,25,90,8,100,211,150,270,61,163,433,44,58,77,0,1137,22,77,Ian Clark,SG,527,39,55,122
82,24,213,8,197,477,360,715,117,356,1071,134,168,82,19,2397,49,150,Jordan Clarkson,SG,1205,88,164,246
83,28,14,0,11,16,13,39,3,13,52,8,10,13,0,125,0,18,Norris Cole,PG,43,8,7,11
84,29,312,9,130,340,267,539,73,175,714,147,171,68,64,2063,23,119,Darren Collison,PG,900,67,114,153
85,36,12,2,21,14,14,22,0,1,23,5,8,20,0,128,9,17,Nick Collison,PF,33,2,4,30
86,29,433,19,211,464,293,590,171,419,1009,316,368,69,68,2292,31,126,Mike Conley,PG,1415,92,156,242
87,24,28,2,42,37,20,39,17,33,72,7,9,39,1,316,10,23,Pat Connaughton,SG,98,6,17,52
88,23,26,0,6,33,22,40,11,26,66,2,5,14,0,188,1,13,Quinn Cook,PG,79,4,13,7
89,26,332,92,644,647,516,1069,131,364,1433,517,670,72,72,2465,153,278,DeMarcus Cousins,C,1942,100,269,797
90,26,102,69,344,292,155,320,137,412,732,143,174,67,67,2119,92,203,Robert Covington,SF,864,127,131,436
91,24,93,20,206,303,169,345,134,302,647,105,124,79,7,2254,19,171,Allen Crabbe,SG,845,54,62,225
92,36,213,14,112,359,243,547,116,322,869,174,203,82,1,2157,17,115,Jamal Crawford,SG,1008,59,134,129
93,28,57,2,30,105,68,123,37,95,218,20,26,19,0,442,4,30,Jordan Crawford,SG,267,11,25,34
94,26,155,23,367,333,176,326,157,394,720,176,217,72,72,2335,48,161,Jae Crowder,SF,999,72,79,415
95,29,36,28,221,174,103,178,71,181,359,16,27,66,35,1649,56,100,Dante Cunningham,SF,435,39,28,277
96,26,188,7,153,338,201,381,137,322,703,85,100,70,42,2029,25,126,Seth Curry,PG,898,79,92,178
97,28,523,17,292,675,351,654,324,789,1443,325,362,79,79,2638,61,183,Stephen Curry,PG,1999,143,239,353
98,25,46,4,79,185,47,140,138,355,495,43,54,67,3,1183,21,90,Troy Daniels,SG,551,21,45,100
99,23,157,167,712,770,730,1393,40,134,1527,519,647,75,75,2708,174,168,Anthony Davis,C,2099,94,181,886
100,20,2,17,40,24,24,47,0,0,47,10,18,36,0,238,20,40,Deyonta Davis,C,58,3,8,60
101,27,27,22,147,75,75,142,0,0,142,50,81,46,12,789,96,137,Ed Davis,PF,200,15,37,243
102,27,44,61,366,161,161,259,0,0,259,65,93,76,37,1330,129,180,Dewayne Dedmon,C,387,37,61,495
103,22,76,21,190,203,143,242,60,187,429,38,68,77,2,1419,94,83,Sam Dekker,SF,504,38,41,284
104,27,193,1,113,145,119,278,26,110,388,75,93,73,2,1248,11,112,Malcolm Delaney,PG,391,39,95,124
105,26,357,0,123,208,129,319,79,215,534,82,96,76,54,1986,24,153,Matthew Dellavedova,PG,577,53,133,147
106,31,74,20,232,164,113,259,51,165,424,46,63,56,49,1486,63,61,Luol Deng,SF,425,48,43,295
107,27,290,13,316,721,688,1421,33,124,1545,545,647,74,74,2620,70,134,DeMar DeRozan,SG,2020,78,180,386
108,20,4,7,50,36,36,76,0,0,76,15,21,17,0,199,23,17,Cheick Diallo,PF,87,4,7,73
109,34,170,9,112,146,126,246,20,81,327,26,35,73,33,1283,46,83,Boris Diaw,PF,338,18,87,158
110,27,158,95,459,332,316,618,16,43,661,136,167,82,82,2653,188,254,Gorgui Dieng,PF,816,88,107,647
111,23,185,23,137,134,96,201,38,101,302,126,159,59,18,1334,27,119,Spencer Dinwiddie,PG,432,44,66,164
112,30,56,5,48,43,36,75,7,42,117,24,29,24,0,394,13,50,Toney Douglas,PG,117,18,21,61
113,30,423,13,217,534,417,835,117,289,1124,298,377,73,73,2459,61,199,Goran Dragic,PG,1483,89,212,278
114,23,89,89,771,483,481,904,2,7,911,137,355,81,81,2409,345,237,Andre Drummond,C,1105,124,152,1116
115,31,121,16,194,157,80,143,77,203,346,43,65,64,7,1362,31,154,Jared Dudley,PF,434,42,72,225
116,36,50,7,97,93,40,86,53,134,220,36,45,53,2,841,18,67,Mike Dunleavy,SF,275,15,28,115
117,22,188,36,142,118,97,240,21,73,313,36,59,78,7,1333,24,178,Kris Dunn,PG,293,78,89,166
118,28,300,99,474,551,434,714,117,312,1026,336,384,62,62,2070,39,117,Kevin Durant,SF,1555,66,138,513
119,25,0,0,6,6,2,3,4,16,19,8,9,5,0,62,1,1,Jarell Eddie,SF,24,1,1,7
120,20,7,1,33,23,13,29,10,35,64,4,8,19,2,146,8,6,Henry Ellenson,PF,60,1,14,41
121,29,70,4,115,231,82,161,149,394,555,37,43,62,13,1500,18,70,Wayne Ellington,SG,648,35,30,133
122,31,236,27,185,247,204,422,43,135,557,93,128,74,33,1998,19,149,Monta Ellis,SG,630,79,135,204
123,22,66,76,182,200,164,331,36,98,429,191,244,31,31,786,61,112,Joel Embiid,C,627,27,117,243
124,26,64,19,190,146,95,184,51,137,321,86,110,64,28,1501,69,165,James Ennis,SF,429,46,59,259
125,22,86,2,36,90,63,138,27,70,208,21,25,53,2,588,10,58,Tyler Ennis,PG,228,26,45,46
126,27,124,9,124,150,108,252,42,118,370,69,92,40,6,788,13,60,Tyreke Evans,SF,411,35,61,137
127,21,112,12,102,155,111,214,44,149,363,58,73,66,26,1228,30,146,Dante Exum,PG,412,21,80,132
128,27,55,40,279,228,228,410,0,6,416,131,189,61,34,1296,182,124,Kenneth Faried,PF,587,43,58,461
129,30,9,0,2,4,0,3,4,9,12,0,0,2,0,35,1,1,Jordan Farmar,PG,12,2,3,3
130,25,56,40,213,203,200,407,3,10,417,67,109,50,39,1186,92,103,Derrick Favors,PF,476,45,60,305
131,21,58,7,38,62,55,136,7,22,158,35,49,42,0,386,3,38,Kay Felder,PG,166,18,31,41
132,24,40,16,187,128,128,222,0,0,222,60,93,66,0,1040,124,110,Cristiano Felicio,C,316,25,33,311
133,32,191,22,184,221,175,370,46,144,514,50,64,80,11,1700,33,125,Raymond Felton,PG,538,67,83,217
134,23,172,9,91,160,92,218,68,176,394,74,89,46,29,1197,20,90,Yogi Ferrell,PG,462,42,70,111
135,23,67,25,166,124,68,142,56,191,333,46,61,81,35,1642,55,125,Dorian Finney-Smith,PF,350,52,45,221
136,23,23,0,21,36,19,46,17,53,99,5,6,36,0,285,2,20,Bryn Forbes,SG,94,1,11,23
137,24,202,4,165,408,280,570,128,360,930,223,277,68,66,2234,44,180,Evan Fournier,SG,1167,66,141,209
138,33,135,9,146,118,51,122,67,203,325,54,63,69,40,1284,9,99,Randy Foye,SG,357,35,80,155
139,26,335,6,139,163,123,276,40,128,404,98,129,65,35,1525,34,133,Tim Frazier,PG,464,56,101,173
140,33,45,37,253,238,101,185,137,335,520,63,74,74,15,1398,37,138,Channing Frye,C,676,33,53,290
141,28,135,15,287,335,209,426,126,324,750,349,387,63,63,2134,39,93,Danilo Gallinari,SF,1145,40,81,326
142,25,93,6,129,207,87,237,120,308,545,51,64,74,2,1495,27,96,Langston Galloway,PG,585,46,46,156
143,23,0,0,6,0,0,2,0,5,7,0,0,5,0,43,1,4,Patricio Garino,SG,0,0,3,7
144,32,338,99,402,532,428,892,104,268,1160,278,332,74,74,2531,60,171,Marc Gasol,C,1446,67,166,462
145,36,150,70,394,303,247,500,56,104,604,130,184,64,39,1627,107,110,Pau Gasol,C,792,24,81,501
146,30,82,26,155,201,159,329,42,113,442,118,138,30,30,1013,35,79,Rudy Gay,SF,562,44,74,190
147,24,2,0,1,1,1,6,0,4,10,2,2,9,0,32,2,2,Michael Gbinije,SG,4,0,0,3
148,29,6,1,11,3,3,11,0,3,14,5,9,13,0,89,4,14,Alonzo Gee,SF,11,5,4,15
149,26,251,27,434,622,427,853,195,496,1349,336,374,75,75,2689,58,206,Paul George,SF,1775,117,218,492
150,22,3,0,8,2,1,5,1,2,7,9,10,5,0,48,1,5,Marcus Georges-Hunt,SG,14,1,2,9
151,29,26,0,21,35,20,50,15,45,95,21,29,17,0,231,1,21,Jonathan Gibson,PG,106,8,21,22
152,31,73,66,328,365,362,696,3,13,709,113,158,78,71,1989,158,163,Taj Gibson,PF,846,42,105,486
153,39,183,16,129,171,82,212,89,227,439,86,107,69,0,1291,28,119,Manu Ginobili,SG,517,82,96,157
154,24,97,214,721,413,413,623,0,1,624,311,476,81,81,2744,314,246,Rudy Gobert,C,1137,49,148,1035
155,22,24,5,21,36,31,51,5,15,66,33,42,15,0,214,7,8,Archie Goodwin,SG,110,4,14,28
156,21,150,40,289,393,316,598,77,267,865,156,217,80,72,2298,116,172,Aaron Gordon,SF,1019,64,89,405
157,28,188,40,172,412,166,355,246,661,1016,147,175,75,15,2323,29,150,Eric Gordon,SG,1217,48,121,201
158,32,121,65,611,390,390,672,0,2,674,103,159,82,82,2556,238,213,Marcin Gortat,C,883,40,118,849
159,23,6,1,17,19,10,25,9,15,40,10,15,27,1,189,5,18,Treveon Graham,SG,57,6,3,22
160,22,46,79,168,152,109,212,43,116,328,90,147,80,4,1531,38,149,Jerami Grant,SF,437,33,44,206
161,24,120,8,94,128,79,167,49,134,301,65,73,63,28,1028,17,93,Jerian Grant,PG,370,47,44,111
162,29,124,58,193,176,58,138,118,311,449,27,32,68,68,1807,31,120,Danny Green,SG,497,71,76,224
163,26,533,106,501,272,191,387,81,263,650,151,213,76,76,2471,98,217,Draymond Green,PF,776,154,184,599
164,31,33,7,68,95,56,121,39,111,232,33,41,47,0,538,17,48,Gerald Green,SF,262,9,25,85
165,26,84,34,377,250,195,355,55,145,500,134,167,77,75,2101,167,248,JaMychal Green,PF,689,46,94,544
166,30,81,13,175,220,167,365,53,193,558,145,168,69,11,1534,39,103,Jeff Green,PF,638,37,75,214
167,27,300,23,385,479,441,858,38,113,971,320,421,61,61,2076,111,157,Blake Griffin,PF,1316,58,142,496
168,26,55,43,191,174,119,198,55,181,379,39,52,64,7,1177,71,91,Justin Hamilton,C,442,29,43,262
169,24,4,13,28,17,12,32,5,10,42,9,20,22,0,163,8,21,A.J. Hammons,C,48,1,10,36
170,24,182,15,189,415,266,495,149,417,912,164,214,79,30,2154,35,103,Tim Hardaway,SG,1143,55,106,224
171,27,906,37,564,674,412,777,262,756,1533,746,881,81,81,2947,95,215,James Harden,PG,2356,120,464,659
172,23,89,70,216,314,246,430,68,194,624,77,124,77,69,2223,125,214,Maurice Harkless,SF,773,85,85,341
173,27,2,0,3,5,3,5,2,7,12,0,0,3,0,31,2,2,Justin Harper,PF,12,0,4,5
174,23,64,42,138,225,224,338,1,7,345,76,121,58,14,1064,81,126,Montrezl Harrell,C,527,20,44,219
175,33,136,7,116,136,78,164,58,177,341,107,129,65,0,1087,11,101,Devin Harris,PG,437,43,57,127
176,22,164,8,130,320,213,382,107,255,637,104,134,57,56,1782,48,92,Gary Harris,SG,851,71,76,178
177,25,54,8,131,154,69,141,85,221,362,35,49,52,11,1138,16,121,Joe Harris,SG,428,30,55,147
178,27,2,0,6,3,3,13,0,2,15,2,4,4,0,25,3,1,Manny Harris,SG,8,0,2,9
179,24,142,39,353,511,402,749,109,314,1063,190,226,82,48,2567,63,133,Tobias Harris,PF,1321,60,95,416
180,22,3,0,3,0,0,2,0,2,4,1,2,5,0,17,0,2,Aaron Harrison,SG,1,0,0,3
181,22,198,20,113,117,74,204,43,156,360,148,194,72,18,1474,23,194,Andrew Harrison,PG,425,54,85,136
182,36,6,1,28,11,11,20,0,3,23,9,15,17,0,130,8,22,Udonis Haslem,C,31,5,8,36
183,28,81,30,153,134,109,196,25,81,277,44,52,54,1,797,38,77,Spencer Hawes,PF,337,15,49,191
184,26,252,20,344,545,396,782,149,374,1156,362,429,73,73,2516,49,117,Gordon Hayward,SF,1601,73,140,393
185,29,112,15,151,234,173,380,61,173,553,133,165,72,41,1667,34,129,Gerald Henderson,SG,662,41,62,185
186,26,57,78,203,159,159,308,0,1,309,74,107,58,39,1123,92,151,John Henson,C,392,29,53,295
187,21,29,12,144,101,55,111,46,113,224,57,76,62,9,842,43,62,Juan Hernangomez,PF,305,29,31,187
188,22,96,36,332,246,242,450,4,15,465,91,125,72,22,1324,170,150,Willy Hernangomez,C,587,41,100,502
189,21,62,14,126,117,74,186,43,144,330,40,50,65,2,960,20,74,Mario Hezonja,SF,317,30,58,146
190,30,21,46,100,80,80,147,0,0,147,61,75,48,13,682,54,100,Roy Hibbert,C,221,8,32,154
191,23,121,9,234,327,179,389,148,379,768,64,76,82,55,1888,35,115,Buddy Hield,SG,866,38,101,269
192,34,65,40,186,245,242,388,3,9,397,116,197,67,8,1198,95,163,Nene Hilario,C,609,56,73,281
193,30,203,11,144,289,195,373,94,233,606,157,196,49,49,1544,23,114,George Hill,PG,829,50,85,167
194,29,0,0,6,5,5,13,0,0,13,2,2,7,0,47,8,9,Jordan Hill,C,12,1,4,14
195,25,141,32,256,183,89,207,94,270,477,103,128,80,71,2374,51,182,Solomon Hill,SF,563,71,82,307
196,23,33,2,31,47,35,80,12,46,126,21,28,39,1,381,2,39,Darrun Hilliard,SG,127,11,28,33
197,26,488,43,218,405,305,613,100,281,894,119,168,67,61,2190,46,133,Jrue Holiday,PG,1029,100,194,264
198,27,102,31,198,233,136,265,97,273,538,66,80,82,4,1639,27,109,Justin Holiday,SG,629,65,66,225
199,22,154,44,356,235,220,475,15,67,542,190,253,78,50,1761,96,177,Rondae Hollis-Jefferson,SF,675,82,116,452
200,23,58,55,217,230,203,335,27,77,412,72,103,57,17,1193,94,136,Richaun Holmes,C,559,42,55,311
201,24,96,11,186,272,158,359,114,307,666,90,115,59,55,1593,16,132,Rodney Hood,SG,748,38,65,202
202,30,337,87,369,379,293,559,86,242,801,108,135,68,68,2193,95,138,Al Horford,C,952,52,116,464
203,23,0,0,1,0,0,0,0,0,0,0,0,1,0,1,0,0,Danuel House,SG,0,0,0,1
204,31,104,92,644,388,388,611,0,2,613,226,424,74,74,2199,296,203,Dwight Howard,C,1002,64,170,940
205,33,52,2,22,25,21,49,4,19,68,9,17,23,1,237,2,16,Marcelo Huertas,PG,63,10,19,24
206,25,3,3,5,6,4,7,2,4,11,0,1,2,0,31,4,0,Josh Huestis,PF,14,0,0,9
207,31,29,21,146,87,68,160,19,54,214,64,82,56,4,689,60,69,Kris Humphries,PF,257,15,28,206
208,23,0,0,1,0,0,0,0,1,1,0,0,3,0,9,0,0,R.J. Hunter,SG,0,0,0,1
209,27,75,124,409,471,347,665,124,317,982,107,125,79,79,2422,129,215,Serge Ibaka,PF,1173,41,105,538
210,33,262,39,253,219,155,238,64,177,415,72,102,76,0,1998,51,97,Andre Iguodala,SF,574,76,58,304
211,29,141,23,366,384,242,488,142,402,890,161,207,82,52,2142,115,211,Ersan Ilyasova,PF,1071,58,116,481
212,29,224,8,237,204,81,172,123,279,451,50,68,82,26,1972,23,163,Joe Ingles,SF,581,96,107,260
213,19,166,36,257,276,221,499,55,187,686,133,214,79,40,2279,60,158,Brandon Ingram,SF,740,50,116,317
214,24,418,25,178,671,494,979,177,441,1420,297,328,72,72,2525,52,157,Kyrie Irving,PG,1816,83,180,230
215,33,5,0,0,2,2,2,0,1,3,2,2,2,0,33,0,4,Jarrett Jack,PG,6,2,3,0
216,22,3,0,2,3,2,3,1,1,4,3,6,5,0,17,2,0,Demetrius Jackson,PG,10,0,0,4
217,25,19,0,8,13,10,28,3,11,39,6,7,8,1,84,1,5,Pierre Jackson,PG,35,2,3,9
218,26,270,5,92,284,218,493,66,184,677,118,136,52,50,1424,21,129,Reggie Jackson,PG,752,35,114,113
219,32,646,44,543,736,612,1002,124,342,1344,358,531,74,74,2794,97,134,LeBron James,SF,1954,92,303,640
220,32,57,16,203,235,235,470,0,1,471,65,85,66,1,931,75,125,Al Jefferson,C,535,19,33,278
221,36,78,10,174,153,91,157,62,186,343,80,108,79,13,1614,28,153,Richard Jefferson,SF,448,26,52,202
222,25,1,0,1,2,1,3,1,2,5,2,2,4,0,13,0,0,John Jenkins,SG,7,0,0,1
223,27,395,5,167,192,113,283,79,252,535,114,152,81,13,1802,29,116,Brandon Jennings,PG,577,70,128,196
224,29,71,17,213,114,69,132,45,130,262,26,37,78,6,1232,60,122,Jonas Jerebko,PF,299,26,39,273
225,29,140,62,248,213,186,304,27,66,370,67,100,80,77,1608,117,211,Amir Johnson,PF,520,52,77,365
226,22,1,1,2,2,2,7,0,0,7,0,0,3,0,9,1,0,Brice Johnson,PF,4,2,1,3
227,29,276,86,309,368,281,513,87,256,769,152,215,76,5,2085,66,197,James Johnson,PF,975,76,171,375
228,35,144,18,209,273,167,368,106,258,626,63,77,78,14,1843,33,93,Joe Johnson,SF,715,36,69,242
229,20,105,24,153,129,84,211,45,154,365,36,53,77,1,1371,36,121,Stanley Johnson,SF,339,56,71,189
230,24,233,44,243,357,264,574,93,250,824,195,254,73,0,2178,50,176,Tyler Johnson,PG,1002,84,90,293
231,29,23,30,155,73,44,82,29,118,200,11,17,68,3,810,26,83,Wesley Johnson,SF,186,29,18,181
232,21,359,56,506,494,449,715,45,139,854,188,228,73,59,2038,212,214,Nikola Jokic,C,1221,61,171,718
233,36,1,0,1,3,3,6,0,2,8,3,4,1,0,12,1,1,Dahntay Jones,SF,9,0,1,2
234,21,0,4,14,8,8,16,0,0,16,3,10,10,0,85,9,15,Damian Jones,C,19,1,6,23
235,19,12,13,40,68,65,110,3,11,121,29,41,32,8,545,39,63,Derrick Jones,SF,168,14,13,79
236,36,14,10,35,44,13,26,31,66,92,13,20,48,2,381,3,37,James Jones,SF,132,7,10,38
237,25,58,54,241,231,212,416,19,75,491,103,170,54,12,1270,65,67,Terrence Jones,PF,584,40,48,306
238,20,156,5,57,75,49,108,26,73,181,33,43,60,0,774,10,50,Tyus Jones,PG,209,47,38,67
239,28,96,135,817,412,412,575,0,2,577,205,425,81,81,2570,297,212,DeAndre Jordan,C,1029,52,116,1114
240,25,265,13,184,299,251,526,48,135,661,94,122,80,22,2003,51,140,Cory Joseph,SG,740,66,108,235
241,23,162,34,279,320,204,448,116,354,802,118,156,75,16,1954,57,139,Frank Kaminsky,C,874,47,76,336
242,24,67,38,287,402,397,699,5,38,737,224,285,72,0,1533,195,154,Enes Kanter,C,1033,32,123,482
243,25,8,5,17,8,4,18,4,10,28,5,6,16,0,110,1,5,Ryan Kelly,PF,25,4,4,18
244,23,114,77,409,295,294,609,1,9,618,152,194,81,81,2349,156,187,Michael Kidd-Gilchrist,SF,743,81,56,565
245,27,157,6,258,305,200,427,105,308,735,204,242,70,24,1754,22,118,Sean Kilpatrick,SG,919,46,136,280
246,25,130,5,93,209,164,386,45,139,525,132,154,54,5,1140,25,87,Brandon Knight,SG,595,27,89,118
247,35,110,21,179,239,77,156,162,359,515,38,42,67,22,1753,8,107,Kyle Korver,SG,678,34,69,187
248,27,47,48,285,216,216,391,0,1,392,38,62,71,62,1419,118,172,Kosta Koufos,C,470,36,61,403
249,27,69,11,79,158,104,201,54,168,369,55,68,68,5,1016,47,79,Mindaugas Kuzminskas,SF,425,29,51,126
250,20,27,13,111,117,114,210,3,8,218,52,74,33,12,612,51,64,Skal Labissiere,PF,289,16,37,162
251,24,75,23,234,226,185,345,41,146,491,110,129,62,5,1143,30,98,Jeremy Lamb,SG,603,27,40,264
252,27,28,1,9,20,10,20,10,27,47,9,9,18,3,174,1,19,Nicolas Laprovittola,PG,59,4,19,10
253,25,70,6,179,148,115,238,33,98,336,46,73,70,1,980,72,83,Joffrey Lauvergne,PF-C,375,25,56,251
254,21,139,10,141,326,206,400,120,310,710,117,140,47,47,1749,18,104,Zach LaVine,SG,889,41,85,159
255,29,335,6,135,237,203,404,34,118,522,173,217,69,24,1732,44,119,Ty Lawson,PG,681,74,129,179
256,22,11,3,18,26,13,38,13,51,89,13,17,35,1,249,6,22,Jake Layman,SF,78,9,11,24
257,31,179,23,207,321,213,435,108,269,704,85,98,77,74,2459,53,141,Courtney Lee,SG,835,81,69,260
258,33,124,40,292,248,248,420,0,0,420,80,113,79,10,1477,148,125,David Lee,PF,576,31,82,440
259,23,44,98,354,230,227,451,3,12,463,150,208,77,34,1560,156,242,Alex Len,C,613,37,102,510
260,25,260,55,350,636,489,925,147,386,1311,469,533,74,74,2474,80,122,Kawhi Leonard,SF,1888,132,154,430
261,24,71,28,209,146,72,165,74,213,378,35,40,74,12,1222,27,172,Meyers Leonard,PF,401,13,35,236
262,27,111,26,300,310,261,479,49,167,646,98,113,75,34,1944,102,145,Jon Leuer,PF,767,31,66,402
263,22,110,8,165,171,112,196,59,184,380,67,93,57,26,1237,23,91,Caris LeVert,SF,468,49,59,188
264,28,54,14,88,55,38,96,17,46,142,25,40,62,19,777,20,81,DeAndre Liggins,SG,152,47,42,108
265,26,439,20,322,661,447,910,214,578,1488,488,545,75,75,2694,46,152,Damian Lillard,PG,2024,68,197,368
266,28,184,14,124,175,117,244,58,156,400,115,141,36,33,883,11,79,Jeremy Lin,PG,523,41,86,135
267,31,139,20,123,173,172,313,1,3,316,42,60,76,3,1345,28,120,Shaun Livingston,PG,389,38,61,151
268,24,13,9,44,61,54,90,7,19,109,19,35,18,0,234,41,49,Shawn Long,C,148,9,13,85
269,20,29,17,80,56,54,98,2,9,107,21,34,53,4,447,44,64,Kevon Looney,C,135,14,17,124
270,28,176,124,282,555,421,785,134,387,1172,295,364,75,75,2222,121,192,Brook Lopez,C,1539,38,184,403
271,28,80,117,276,382,382,773,0,2,775,75,104,81,81,2271,243,151,Robin Lopez,C,839,18,90,519
272,28,116,22,518,370,225,478,145,389,867,257,295,60,60,1885,148,125,Kevin Love,PF,1142,53,122,666
273,30,417,19,240,426,233,450,193,468,918,299,365,60,60,2244,48,170,Kyle Lowry,PG,1344,88,173,288
274,34,1,0,0,1,1,3,0,1,4,0,0,5,0,11,0,0,John Lucas III,PG,2,2,0,0
275,21,75,10,124,145,95,200,50,161,361,105,123,69,19,1190,25,154,Timothe Luwawu-Cabarrot,SF,445,32,73,149
276,21,70,20,187,159,94,235,65,204,439,57,79,71,4,1158,48,97,Trey Lyles,PF,440,26,64,235
277,26,154,3,108,170,133,261,37,120,381,53,77,55,9,1205,20,100,Shelvin Mack,PG,430,42,90,128
278,30,19,24,103,65,65,111,0,0,111,43,75,31,0,555,47,90,Ian Mahinmi,C,173,33,34,150
279,19,23,26,74,83,55,107,28,74,181,32,49,57,34,562,40,84,Thon Maker,C,226,10,17,114
280,28,9,12,84,72,72,132,0,0,132,47,58,35,0,293,46,25,Boban Marjanovic,C,191,6,10,130
281,22,8,9,120,58,49,126,9,25,151,40,50,42,3,558,42,91,Jarell Martin,PF,165,17,28,162
282,30,210,16,241,333,159,368,174,479,847,146,179,73,73,2495,18,161,Wesley Matthews,SG,986,77,102,259
283,30,39,35,127,191,148,268,43,110,378,59,87,80,76,1787,47,122,Luc Mbah a Moute,SF,484,81,47,174
284,24,17,29,56,62,60,109,2,8,117,21,42,52,2,457,34,47,James Michael McAdoo,PF,147,18,19,90
285,21,77,15,79,106,65,122,41,123,245,29,37,71,20,1074,22,62,Patrick McCaw,SG,282,32,36,101
286,24,15,2,30,30,23,45,7,30,75,23,27,30,3,287,4,17,Sheldon McClellan,SG,90,8,5,34
287,25,285,42,231,692,507,1001,185,440,1441,268,294,80,80,2796,60,202,C.J. McCollum,SG,1837,72,172,291
288,24,534,10,212,236,225,457,11,55,512,73,90,81,51,2133,39,139,T.J. McConnell,PG,556,134,159,251
289,21,2,2,10,16,15,25,1,7,32,3,5,16,0,80,9,7,Chris McCullough,PF,36,2,3,19
290,23,13,18,67,77,57,103,20,66,169,32,38,49,0,505,15,49,K.J. McDaniels,SF,206,19,29,82
291,25,58,5,159,222,145,290,77,207,497,71,84,66,5,1508,20,79,Doug McDermott,SF,592,13,38,179
292,29,17,67,144,208,208,315,0,4,319,56,111,77,10,739,100,109,JaVale McGee,C,472,19,40,244
293,25,124,18,162,190,117,240,73,220,460,44,71,78,65,1966,95,140,Rodney McGruder,SG,497,45,56,257
294,23,51,6,111,180,115,249,65,170,419,70,93,61,26,1176,19,108,Ben McLemore,SG,495,29,62,130
295,25,19,6,34,58,40,99,18,51,150,27,34,37,4,384,6,31,Jordan McRae,SG,161,8,14,40
296,29,50,4,51,44,31,87,13,31,118,6,9,22,14,381,23,31,Josh McRoberts,PF,107,10,23,74
297,29,45,4,72,103,47,119,56,137,256,65,74,36,10,738,5,41,Jodie Meeks,SG,327,34,36,77
298,30,14,61,211,88,87,134,1,3,137,36,61,73,11,905,97,152,Salah Mejri,C,213,32,40,308
299,22,7,6,21,15,15,33,0,1,34,8,14,25,1,141,13,12,Jordan Mickey,PF,38,3,9,34
300,25,99,7,112,150,105,229,45,104,333,81,92,29,23,889,11,79,Khris Middleton,SF,426,41,65,123
301,29,48,25,199,281,112,238,169,409,647,84,93,76,29,1776,30,151,C.J. Miles,SF,815,46,40,229
302,36,22,0,36,9,1,3,8,20,23,2,2,20,0,151,3,9,Mike Miller,SF,28,2,13,39
303,28,280,3,118,273,126,266,147,356,622,66,80,80,8,1754,24,109,Patty Mills,PG,759,65,101,142
304,29,1,0,3,1,1,5,0,2,7,1,2,2,0,23,3,2,Elijah Millsap,SG,3,0,2,6
305,31,252,62,422,430,355,731,75,241,972,311,405,69,67,2343,111,186,Paul Millsap,PF,1246,90,158,533
306,25,75,56,323,258,129,248,129,377,625,99,128,70,15,1679,61,128,Nikola Mirotic,PF,744,53,79,384
307,26,187,38,365,387,387,722,0,4,726,177,239,81,0,1823,167,168,Greg Monroe,C,951,92,140,532
308,27,164,32,119,283,206,411,77,208,619,57,74,73,22,1820,33,131,E'Twaun Moore,SG,700,50,62,152
309,27,160,25,289,421,303,650,118,357,1007,145,185,79,79,2565,77,168,Marcus Morris,SF,1105,52,87,366
310,27,126,42,385,406,335,693,71,196,889,180,215,76,76,2374,107,254,Markieff Morris,PF,1063,82,129,492
311,31,25,2,19,98,57,119,41,133,252,34,37,49,7,714,12,44,Anthony Morrow,SG,271,24,6,31
312,26,34,11,75,57,46,91,11,47,138,25,49,34,0,479,26,55,Donatas Motiejunas,PF,150,18,31,101
313,30,43,31,160,169,169,327,0,1,328,63,78,54,52,1104,104,133,Timofey Mozgov,C,401,16,72,264
314,20,217,13,149,208,152,373,56,178,551,131,167,55,41,1406,29,95,Emmanuel Mudiay,PG,603,41,123,178
315,24,35,6,136,288,239,452,49,146,598,147,190,78,1,1516,84,86,Shabazz Muhammad,SF,772,22,56,220
316,20,48,6,36,50,41,93,9,23,116,21,30,38,8,322,6,29,Dejounte Murray,PG,130,8,38,42
317,19,170,24,173,295,180,386,115,344,730,106,120,82,10,1764,41,124,Jamal Murray,SG,811,52,113,214
318,25,95,41,164,170,124,227,46,110,337,49,64,70,3,1237,76,97,Mike Muscala,C,435,30,55,240
319,24,96,40,249,190,180,325,10,36,361,59,80,63,7,1442,120,149,Larry Nance Jr.,PF,449,82,56,369
320,25,67,2,53,73,39,91,34,92,183,38,49,53,2,512,8,38,Shabazz Napier,PG,218,32,41,61
321,24,8,8,42,39,38,79,1,7,86,19,26,32,4,331,22,30,Maurice Ndour,PF,98,15,12,64
322,32,1,0,1,0,0,5,0,2,7,4,4,2,0,18,0,1,Gary Neal,SG,4,0,0,1
323,34,385,8,164,268,162,331,106,273,604,45,63,75,39,2045,28,197,Jameer Nelson,PG,687,53,129,192
324,24,34,5,26,41,31,60,10,31,91,8,9,40,0,346,4,48,Raul Neto,PG,100,21,15,30
325,23,5,0,15,9,8,24,1,12,36,2,2,23,0,93,2,6,Georges Niang,PF,21,3,5,17
326,27,10,6,46,43,38,84,5,27,111,9,14,38,0,342,15,55,Andrew Nicholson,PF,100,16,17,61
327,31,103,37,241,99,99,200,0,1,201,34,78,46,46,1015,161,127,Joakim Noah,C,232,30,58,402
328,22,50,51,201,184,184,308,0,1,309,77,111,51,19,1047,93,126,Nerlens Noel,C,445,65,51,294
329,24,42,90,161,103,100,144,3,12,156,44,67,57,6,1088,82,137,Lucas Nogueira,C,253,52,46,243
330,33,0,0,3,2,1,1,1,6,7,0,0,8,0,22,0,1,Steve Novak,PF,5,0,0,3
331,38,82,38,330,296,217,469,79,209,678,98,112,54,54,1424,23,113,Dirk Nowitzki,PF,769,30,51,353
332,22,123,74,313,271,271,533,0,1,534,120,210,65,48,1391,154,161,Jusuf Nurkic,C,662,50,143,467
333,24,14,7,46,47,46,76,1,5,81,25,39,20,2,397,16,36,David Nwaba,SG,120,13,11,62
334,23,6,1,10,15,12,24,3,6,30,5,6,11,0,80,9,10,Johnny O'Bryant,PF,38,0,6,19
335,26,117,104,282,215,213,396,2,17,413,64,83,79,8,1229,157,174,Kyle O'Quinn,C,496,36,76,439
336,23,3,0,17,12,12,27,0,0,27,0,2,19,0,75,5,17,Daniel Ochefu,C,24,2,3,22
337,21,58,49,159,242,242,471,0,0,471,106,158,50,33,1134,81,122,Jahlil Okafor,C,590,20,91,240
338,24,176,21,252,412,285,580,127,352,932,116,154,67,67,2222,39,155,Victor Oladipo,SG,1067,78,119,291
339,25,148,29,288,260,192,316,68,192,508,90,123,75,6,1538,72,207,Kelly Olynyk,C,678,43,96,360
340,29,2,1,4,2,2,4,0,0,4,0,0,8,0,28,2,3,Arinze Onuaku,C,4,0,2,6
341,20,3,1,8,5,5,7,0,0,7,4,4,5,1,52,2,6,Chinanu Onuaku,C,14,3,4,10
342,21,47,17,199,186,132,254,54,188,442,75,99,79,5,1605,61,195,Kelly Oubre,SF,501,58,49,260
343,32,132,33,270,164,164,305,0,2,307,98,126,70,70,1268,140,166,Zaza Pachulia,C,426,59,88,410
344,19,20,17,62,56,56,100,0,2,102,12,14,22,0,355,24,44,Georgios Papagiannis,C,124,3,24,86
345,21,142,22,235,399,334,636,65,178,814,162,218,51,50,1728,79,111,Jabari Parker,PF,1025,51,92,314
346,34,285,2,104,265,242,500,23,69,569,85,117,63,63,1587,9,92,Tony Parker,PG,638,33,89,113
347,28,55,5,78,75,50,129,25,93,222,35,43,34,34,675,6,52,Chandler Parsons,SF,210,20,24,84
348,25,6,0,6,3,2,9,1,6,15,2,3,5,0,40,1,6,Lamar Patterson,SG,9,1,4,7
349,27,76,23,229,154,60,131,94,253,384,43,60,65,8,1599,62,120,Patrick Patterson,PF,445,40,38,291
350,31,563,8,263,374,250,483,124,302,785,232,260,61,61,1921,41,146,Chris Paul,PG,1104,118,147,304
351,25,7,7,24,23,20,39,3,15,54,14,19,18,0,135,9,32,Adreian Payne,PF,63,8,8,33
352,22,55,5,45,64,37,107,27,86,193,5,8,31,0,462,3,52,Cameron Payne,PG,160,14,29,48
353,22,529,40,298,430,390,766,40,146,912,146,211,82,58,2412,89,177,Elfrid Payton,PG,1046,88,178,387
354,24,13,4,12,8,7,13,1,9,22,3,5,6,0,99,0,9,Gary Payton,PG,20,3,10,12
355,39,10,5,47,28,13,27,15,43,70,10,13,25,7,277,1,40,Paul Pierce,SF,81,4,16,48
356,24,10,4,28,16,16,30,0,0,30,8,19,21,1,170,23,23,Marshall Plumlee,C,40,4,12,51
357,26,284,92,436,334,334,617,0,6,623,174,300,81,64,2148,170,226,Mason Plumlee,C,842,69,135,606
358,28,21,13,57,44,44,92,0,0,92,25,39,45,12,484,38,73,Miles Plumlee,C,113,18,30,95
359,21,12,20,87,67,67,115,0,0,115,31,57,54,4,626,78,113,Jakob Poeltl,C,165,17,29,165
360,23,121,41,397,414,266,462,148,341,803,99,119,80,80,2605,118,193,Otto Porter,SF,1075,116,43,515
361,21,35,11,221,183,151,279,32,96,375,39,59,64,13,1000,75,94,Bobby Portis,PF,437,16,37,296
362,21,97,130,364,443,331,671,112,314,985,198,252,66,65,2164,111,244,Kristaps Porzingis,PF,1196,47,118,475
363,25,49,39,213,194,173,303,21,74,377,107,141,77,3,1333,93,135,Dwight Powell,C,516,61,34,306
364,23,82,14,142,227,171,333,56,173,506,126,159,76,18,1368,26,127,Norman Powell,SG,636,51,70,168
365,23,5,2,18,25,19,35,6,19,54,8,10,6,1,157,11,14,Alex Poythress,PF,64,3,3,29
366,33,18,1,8,4,1,7,3,17,24,3,4,14,0,134,3,14,Ronnie Price,PG,14,11,3,11
367,22,11,3,10,13,8,16,5,13,29,0,3,16,0,80,4,6,Tim Quarterman,SG,31,2,11,14
368,23,34,2,26,40,24,51,16,47,98,41,43,26,0,299,6,39,Chasson Randle,PG,137,9,19,32
369,22,264,37,485,377,360,710,17,63,773,204,282,74,73,2132,151,248,Julius Randle,PF,975,49,173,636
370,35,122,10,416,433,412,870,21,94,964,141,193,73,5,1786,182,136,Zach Randolph,PF,1028,38,99,598
371,32,110,13,160,396,195,422,201,468,890,180,202,78,78,2198,11,125,J.J. Redick,SG,1173,55,98,171
372,26,26,47,203,162,161,281,1,4,285,49,88,71,5,1031,129,137,Willie Reed,C,374,18,31,332
373,23,140,39,133,202,127,286,75,227,513,60,77,53,34,1614,35,132,Josh Richardson,SG,539,60,65,168
374,21,11,1,20,28,20,40,8,28,68,15,19,22,0,198,3,23,Malachi Richardson,SG,79,5,8,23
375,24,204,10,141,323,212,432,111,299,731,132,191,74,29,2054,20,187,Austin Rivers,SG,889,48,115,161
376,25,79,79,304,215,170,279,45,184,463,47,111,79,79,2376,98,204,Andre Roberson,SF,522,94,51,402
377,31,52,1,34,46,29,78,17,44,122,33,39,41,2,416,5,18,Brian Roberts,PG,142,9,26,39
378,23,47,20,188,158,109,213,49,125,338,54,76,69,27,1426,57,63,Glenn Robinson,SF,419,41,37,245
379,25,31,9,139,105,105,195,0,1,196,31,66,48,1,560,84,76,Thomas Robinson,PF,241,26,46,223
380,30,344,4,136,210,118,284,92,252,536,18,27,68,30,1518,21,95,Sergio Rodriguez,PG,530,48,128,157
381,30,461,11,282,229,179,428,50,133,561,30,50,69,42,1843,73,144,Rajon Rondo,PG,538,99,168,355
382,28,283,17,180,460,447,917,13,60,977,221,253,64,64,2082,66,84,Derrick Rose,PG,1154,44,147,246
383,25,88,33,189,326,184,355,142,391,746,64,77,78,24,1955,18,143,Terrence Ross,SF,858,88,68,207
384,22,131,11,187,151,94,232,57,179,411,51,66,74,0,1263,40,69,Terry Rozier,PG,410,45,47,227
385,26,682,10,237,261,201,454,60,196,650,254,285,75,75,2469,68,202,Ricky Rubio,PG,836,128,195,305
386,30,20,1,20,31,11,24,20,64,88,0,0,45,0,314,5,31,Damjan Rudez,SF,82,12,9,25
387,31,45,23,83,70,26,73,44,114,187,13,18,47,33,1030,16,42,Brandon Rush,SG,197,22,28,99
388,20,303,16,191,351,216,483,135,384,867,147,188,63,60,1811,31,130,D'Angelo Russell,PG,984,87,176,222
389,20,82,32,242,192,141,322,51,159,481,44,67,81,66,1632,45,200,Domantas Sabonis,PF,479,39,83,287
390,28,0,1,1,1,1,4,0,0,4,2,2,5,0,13,3,5,Larry Sanders,C,4,1,2,4
391,22,182,30,401,381,275,586,106,341,927,172,220,81,36,2129,112,162,Dario Saric,PF,1040,57,183,513
392,25,92,6,58,61,52,109,9,37,146,23,33,57,3,719,25,60,Tomas Satoransky,SG,154,26,38,83
393,23,499,16,206,548,448,921,100,294,1215,218,255,79,78,2485,42,149,Dennis Schroder,PG,1414,74,258,248
394,36,37,4,88,71,54,101,17,50,151,25,37,36,1,461,51,63,Luis Scola,PF,184,14,34,139
395,28,17,3,27,17,13,32,4,27,59,7,8,18,0,195,10,12,Mike Scott,PF,45,4,8,37
396,32,107,31,216,174,133,275,41,120,395,55,75,62,42,1596,54,97,Thabo Sefolosha,SF,444,96,58,270
397,22,13,1,15,25,18,30,7,28,58,14,22,14,5,236,1,18,Wayne Selden,SG,71,6,12,16
398,27,23,20,101,109,109,196,0,2,198,14,22,49,3,559,41,66,Kevin Seraphin,PF,232,7,29,142
399,30,129,3,62,100,79,201,21,62,263,91,118,50,1,811,11,43,Ramon Sessions,PG,312,26,46,73
400,26,109,27,180,201,107,228,94,261,489,71,90,76,31,1937,39,150,Iman Shumpert,SG,567,62,78,219
401,22,17,45,121,103,102,198,1,7,205,22,32,55,38,859,64,109,Pascal Siakam,PF,229,26,33,185
402,27,126,25,140,177,147,319,30,102,421,99,132,78,8,1392,20,146,Jonathon Simmons,SG,483,47,76,160
403,28,9,5,40,34,27,46,7,37,83,13,17,32,2,385,8,29,Kyle Singler,SF,88,7,11,48
404,22,364,34,228,269,175,417,94,332,749,203,250,79,24,2399,78,192,Marcus Smart,SG,835,125,159,306
405,28,418,33,214,329,301,644,28,105,749,72,102,81,32,1955,21,127,Ish Smith,PG,758,61,112,235
406,31,62,11,96,123,28,85,95,271,356,10,15,41,35,1187,17,77,J.R. Smith,SG,351,40,26,113
407,30,37,55,194,174,137,251,37,78,329,35,51,74,3,1068,64,168,Jason Smith,C,420,21,58,258
408,25,96,14,226,246,102,186,144,355,541,47,58,80,80,2336,22,125,Tony Snell,SG,683,54,55,248
409,29,66,41,285,244,141,271,103,277,548,120,137,82,2,1286,88,229,Marreese Speights,C,711,23,69,373
410,32,4,1,14,14,12,25,2,6,31,9,11,8,0,76,8,8,Tiago Splitter,C,39,1,6,22
411,23,188,32,205,251,119,275,132,359,634,122,150,80,27,2188,21,144,Nik Stauskas,SG,756,45,128,226
412,26,59,3,48,54,48,100,6,20,120,8,13,18,0,361,4,32,Lance Stephenson,SG,122,5,26,52
413,23,2,0,1,1,1,1,0,0,1,1,2,2,0,7,1,3,Jarnell Stokes,C,3,1,0,2
414,19,0,1,5,3,3,13,0,0,13,4,4,7,0,24,1,5,Diamond Stone,C,10,0,2,6
415,30,84,0,78,91,72,184,19,60,244,80,107,39,0,696,6,44,Rodney Stuckey,PG,281,16,53,84
416,24,3,1,17,15,12,30,3,18,48,4,8,11,1,118,10,17,Jared Sullinger,PF,37,4,4,27
417,24,1,6,7,4,4,5,0,0,5,0,3,2,0,28,4,3,Edy Tavares,C,8,0,2,11
418,22,3,1,2,1,1,5,0,2,7,1,2,4,0,52,1,6,Isaiah Taylor,PG,3,1,0,3
419,28,639,32,298,402,312,657,90,252,909,360,415,82,82,2657,33,165,Jeff Teague,PG,1254,100,216,331
420,31,48,13,151,156,52,113,104,305,418,35,45,70,2,1133,11,109,Mirza Teletovic,PF,451,12,37,162
421,30,169,28,151,183,101,212,82,220,432,58,74,65,21,1728,32,141,Garrett Temple,SG,506,84,78,183
422,39,98,20,91,105,32,72,73,171,243,24,29,74,0,1365,15,95,Jason Terry,SG,307,45,36,106
423,27,449,13,162,682,437,827,245,646,1473,590,649,76,76,2569,43,167,Isaiah Thomas,PG,2199,70,210,205
424,28,35,5,110,97,59,159,38,85,244,43,51,46,15,968,32,85,Lance Thomas,PF,275,21,25,142
425,25,35,6,92,77,45,105,32,95,200,19,29,40,9,752,19,69,Hollis Thompson,SG,205,20,11,111
426,26,160,40,236,644,376,729,268,647,1376,186,218,78,78,2649,49,139,Klay Thompson,SG,1742,66,128,285
427,25,77,84,429,262,262,434,0,3,437,106,213,78,78,2336,287,176,Tristan Thompson,C,630,39,64,716
428,29,41,3,54,84,56,130,28,80,210,23,27,33,1,575,22,48,Marcus Thornton,SG,219,19,25,76
429,22,1,0,1,1,1,4,0,0,4,0,0,2,0,25,2,2,Mike Tobey,C,2,0,1,3
430,31,77,20,188,155,65,121,90,230,351,61,82,65,9,1477,51,109,Anthony Tolliver,PF,461,33,56,239
431,24,0,1,1,5,4,5,1,4,9,0,0,4,0,47,0,6,Axel Toupane,SF,11,1,0,1
432,21,220,103,711,802,701,1204,101,275,1479,356,428,82,82,3030,296,241,Karl-Anthony Towns,C,2061,57,212,1007
433,31,99,19,355,199,129,286,70,196,482,72,93,81,21,2236,117,196,P.J. Tucker,SF,540,116,66,472
434,28,205,24,211,235,204,434,31,118,552,85,103,65,12,1658,36,121,Evan Turner,SF,586,53,100,247
435,20,106,173,448,444,404,754,40,115,869,245,303,81,81,2541,139,262,Myles Turner,C,1173,74,105,587
436,34,131,0,51,92,81,165,11,32,197,32,34,39,0,560,6,29,Beno Udrih,PG,227,13,37,57
437,21,226,5,75,184,163,358,21,79,437,55,71,61,15,1123,20,73,Tyler Ulis,PG,444,48,77,95
438,23,9,4,14,16,13,29,3,9,38,5,7,9,0,115,8,8,Jarrod Uthoff,PF,40,2,3,22
439,24,57,63,533,391,390,700,1,2,702,176,217,80,80,2066,226,216,Jonas Valanciunas,C,959,37,106,759
440,23,63,7,140,102,29,80,73,208,288,14,18,57,0,976,11,86,Denzel Valentine,SG,291,30,49,151
441,22,35,2,38,39,28,82,11,29,111,18,22,37,0,294,4,36,Fred VanVleet,PG,107,17,15,42
442,34,10,3,15,5,5,14,0,0,14,8,11,14,1,92,12,16,Anderson Varejao,C,18,3,8,27
443,30,5,1,2,2,1,5,1,3,8,2,3,3,0,39,0,6,Greivis Vasquez,PG,7,1,1,2
444,20,23,10,45,57,31,75,26,81,156,2,5,41,2,458,4,32,Rashad Vaughn,SG,142,19,14,49
445,21,31,27,256,130,123,250,7,20,270,60,94,74,41,1265,131,154,Noah Vonleh,PF,327,30,64,387
446,26,208,74,603,483,460,956,23,75,1031,107,160,75,55,2163,176,180,Nikola Vucevic,C,1096,77,117,779
447,32,52,2,47,42,19,62,23,74,136,17,24,42,4,408,12,38,Sasha Vujacic,SG,124,13,16,59
448,35,229,41,207,414,369,810,45,145,955,223,281,60,59,1792,64,112,Dwyane Wade,SG,1096,86,138,271
449,25,200,20,136,281,196,448,85,215,663,82,127,46,43,1384,18,95,Dion Waiters,SG,729,41,103,154
450,26,435,22,263,643,403,847,240,602,1449,304,359,79,79,2739,45,119,Kemba Walker,PG,1830,85,168,308
451,26,831,49,268,647,558,1163,89,272,1435,422,527,78,78,2836,58,151,John Wall,PG,1805,157,323,326
452,22,55,27,132,114,81,183,33,102,285,74,94,59,10,981,25,96,Taurean Waller-Prince,SF,335,43,61,157
453,23,75,39,214,403,377,716,26,98,814,119,154,66,59,2048,125,175,T.J. Warren,SF,951,76,57,339
454,32,114,2,73,96,64,143,32,105,248,57,66,62,9,1012,16,84,C.J. Watson,PG,281,43,47,89
455,24,21,1,18,25,24,50,1,10,60,11,16,20,0,205,8,16,Briante Weber,PG,62,12,8,26
456,36,151,48,156,135,132,244,3,8,252,43,56,68,0,854,47,105,David West,C,316,42,78,203
457,28,840,31,727,824,624,1358,200,583,1941,710,840,81,81,2802,137,190,Russell Westbrook,PG,2558,133,438,864
458,24,21,10,57,33,21,53,12,34,87,20,22,35,0,471,25,52,Okaro White,PF,98,10,18,82
459,21,192,36,152,204,160,359,44,149,508,91,113,73,26,1643,32,175,Isaiah Whitehead,PG,543,42,142,184
460,27,57,161,795,542,542,973,0,0,973,225,358,77,77,2513,293,226,Hassan Whiteside,C,1309,56,154,1088
461,21,189,30,226,709,606,1281,103,289,1570,412,542,82,82,3048,103,183,Andrew Wiggins,SF,1933,82,187,329
462,26,12,1,8,8,5,16,3,15,31,2,2,22,0,108,4,8,C.J. Wilcox,SG,21,2,6,12
463,24,23,32,198,138,138,266,0,1,267,70,112,47,0,708,94,125,Alan Williams,C,346,27,37,292
464,32,360,8,133,263,178,366,85,234,600,90,109,64,44,1657,14,138,Deron Williams,PG,701,31,138,147
465,25,28,7,111,108,78,147,30,97,244,58,89,50,11,804,19,60,Derrick Williams,PF,304,14,28,130
466,30,239,19,176,428,265,552,163,446,998,402,457,81,1,1994,26,92,Lou Williams,SG,1421,80,160,202
467,30,106,53,409,297,173,350,124,354,704,131,150,76,76,2295,89,134,Marvin Williams,PF,849,58,60,498
468,30,4,0,4,8,3,12,5,11,23,6,7,6,0,79,2,2,Reggie Williams,SF,27,3,0,6
469,22,25,10,54,73,55,105,18,62,167,21,32,30,16,557,15,60,Troy Williams,SF,185,27,33,69
470,24,2,1,6,4,0,1,4,13,14,1,2,14,0,44,4,4,Kyle Wiltjer,PF,13,3,5,10
471,20,66,6,71,80,73,190,7,35,225,29,47,18,15,625,23,52,Justise Winslow,SF,196,27,33,94
472,26,7,32,69,55,55,102,0,1,103,36,48,51,1,432,52,52,Jeff Withey,C,146,16,14,121
473,21,2,6,15,12,12,18,0,5,23,11,15,13,0,107,14,11,Christian Wood,PF,35,3,7,29
474,37,11,2,15,19,10,30,9,38,68,10,16,25,2,160,5,18,Metta World Peace,SF,57,9,7,20
475,29,15,20,47,83,83,134,0,1,135,23,35,28,5,447,31,42,Brandan Wright,PF,189,11,10,78
476,24,57,11,32,49,39,86,10,30,116,42,55,27,0,446,16,31,Delon Wright,PG,150,27,25,48
477,21,4,2,20,25,13,23,12,35,58,6,9,29,0,220,6,15,James Young,SG,68,10,4,26
478,24,15,0,16,26,21,49,5,23,72,11,15,33,0,135,1,5,Joe Young,PG,68,4,5,17
479,31,58,14,112,272,102,212,170,421,633,77,90,60,60,1556,25,137,Nick Young,SG,791,37,36,137
480,28,122,30,318,362,317,569,45,118,687,45,86,74,74,2237,131,135,Thaddeus Young,PF,814,114,96,449
481,24,99,58,270,253,253,442,0,1,443,133,196,62,58,1725,135,189,Cody Zeller,PF,639,62,65,405
482,27,42,21,81,78,78,157,0,1,158,22,39,51,5,525,43,61,Tyler Zeller,C,178,7,20,124
483,20,4,5,24,10,10,31,0,0,31,3,5,19,0,108,11,17,Stephen Zimmerman,C,23,2,3,35
484,22,36,16,110,88,55,122,33,99,221,31,40,44,18,843,15,78,Paul Zipser,SF,240,15,40,125
485,19,30,33,118,126,126,235,0,3,238,32,49,38,11,609,41,66,Ivica Zubac,C,284,14,30,159
